no references
    bitm: bitmap
    trak: camera_track
    colo: color_table
    cdmg: continuous_damage_effect
    hmt : hud_message_text
    devc: input_device_defaults
    phys: physics
    pphy: point_physics
    snde: sound_environment
    shdr: shader
    boom: spheroid
    str#: string_list
    ustr: unicode_string_list
    wind: wind

noncircular references
    ant!: antenna
    cont: contrail
    deca: decal
    dobc: detail_object_collection
    flag: flag
    font: font
    hud#: hud_number
    lens: lens_flare
    ligh: light
    mgs2: light_volume
    elec: lightning
    metr: meter
    mply: multiplayer_scenario_description
    ngpr: preferences_network_game
    vcky: virtual_keyboard
    senv: shader_environment
    soso: shader_model
    schi: shader_transparent_chicago
    scex: shader_transparent_chicago_extended
    sotr: shader_transparent_generic
    sgla: shader_transparent_glass
    smet: shader_transparent_meter
    spla: shader_transparent_plasma
    swat: shader_transparent_water
    rain: weather_particle_system
 
circular references
    actr: actor
    actv: actor_varient
    bipd: biped
    udlg: dialogue
    devi: device
    ctrl: device_control
    lifi: device_light_fixture
    mach: device_machine
    jpt!: damage_effect
    effe: effect
    eqip: equipment
    fog : fog
    garb: garbage
    mod2: gbxmodel
    matg: globals
    glw!: glow
    grhi: grenade_hud_interface
    hudg: hud_globals
    item: item
    itmc: item_collection
    foot: material_effects
    mode: model
    antr: model_animations
    coll: model_collision_geometry
    obje: object
    part: particle
    pctl: particle_system
    plac: placeholder
    proj: projectile
    scnr: scenario
    sbsp: scenario_structure_bsp
    scen: scenery
    snd!: sound
    lsnd: sound_looping
    ssce: sound_scenery
    sky : sky
    tagc: tag_collection
    Soul: ui_widget_collection
    DeLa: ui_widget_definition
    unit: unit
    unhi: unit_hud_interface
    vehi: vehicle
    weap: weapon
    wphi: weapon_hud_interface

Find max size for tag path strings and max size for all rawdata_ref fields
REMEMBER TO GO BACK TO DeLa AND FINISH THE ENUMERATOR OPTIONS